########################################################################################################################
########################################################################################################################
#####................................................###########...................................................#####
#####..............................................................................................................#####
#####..........................................................................................................c.P.#####
#####################################################...........########################################################
#####..............................................................................................................#####
#####..............................................................................................................#####
#####................................................###########...................................................#####
#####..............................................................................................................#####
#####..............................................................................................................#####
#####################################################...........########################################################
#####..............................................................................................................#####
#####..............................................................................................................#####
#####................................................###########...................................................#####
#####..............................................................................................................#####
#####..............................................................................................................#####
#####################################################...........########################################################
#####..............................................................................................................#####
#####..............................................................................................................#####
#####.p.C............................................##########....................................................#####
########################################################################################################################
########################################################################################################################