########################################################################################################################
########################################################################################################################
#####..............................................................................................................#####
#####..............................................................................................................#####
#####.P..c....................................................................................................C..p.#####
#################################################..............................#########################################
#####............................................##..........................###...................................#####
#####..............................................##........................#.....................................#####
#####.............##################................#.....................................########.................#####
#####...............................####............#.................#####.......................####.............#####
#####...................................####...........##.............###############.................####.........#####
###################.......................................................................................####.....#####
#####...............................................###.................................#######....................#####
#####..........................................................................................####................#####
#####...........##############################...###...............................................#####################
#####.....................................................................###############..........................#####
#####....................................................................................##........................#####
#####.........................####........####.......####..................................##......................#####
#####.....................####........####.......####.......#################................###########################
#####.................####........####.............................................................................#####
#####.............####.............................................................................................#####
########################################################################################################################
########################################################################################################################