########################################################################################################################
########################################################################################################################
#####..............................................................................................................#####
#####..............................................................................................................#####
#####..............................................................................................................#####
#####..............................................................................................................#####
#####..............................................................................................................#####
#####..............................................................................................................#####
#####..............................................................................................................#####
#####..............................................................................................................#####
#####..............................................................................................................#####
#####..............................................................................................................#####
#####..............................................................................................................#####
#####..............................................................................................................#####
#####..............................................................................................................#####
#####..............................................................................................................#####
#####..............................................................................................................#####
#####..............................................................................................................#####
#####..............................................................................................................#####
#####....................................................S.........................................................#####
#####.C.....................~.........#############################################..............................P.#####
########################################################################################################################
########################################################################################################################