########################################################################################################################
########################################################################################################################
#####..............................................................................................................#####
#####..............................................................................................................#####
#####..............................................................................................................#####
#####..............................................................................................................#####
#####..............................................................................................................#####
#####..............................................................................................................#####
#####..............................................................................................................#####
#####..............................................................................................................#####
#####..............................................................................................................#####
#####..............................................................................................................#####
#####..............................................................................................................#####
#####............................................................................................................P.#####
#####......................................#############......##########################################################
#####..............................................................................................................#####
#####........................###########...........................................................................#####
#####..............................................................................................................#####
#####..........##########..........................................................................................#####
#####..............................................................................................................#####
#####.C...~........................................................................................................#####
########################################################################################################################
########################################################################################################################