########################################################################################################################
########################################################################################################################
#####..............................................................................................................#####
#####p..C..........................................................................................................#####
##############.....................................................................................................#####
#######################..........................................................................................#######
############..####............................................................................................##########
#####............###.....................................................................................###############
#####.............##########################................############################################################
#####.......................................##............###......................................................#####
#################.............................##.......###........................................#................#####
#####...........................................#.....##.............###################..........#................#####
#####........################....................#................................................#................#####
########.....................########.................################............................#................#####
#####..##............................#####################........................................#................#####
#####...##............................................................###########.................#................#####
#####.....##......................................................................................#................#####
#####.......##.............###########################..............###############################................#####
#####.........##..............................................................................................c..P.#####
#####...........##.....................................................................................#################
#####.............................................................................................######################
########################################################################################################################
########################################################################################################################