########################################################################################################################
########################################################################################################################
#####..............................................................................................................#####
#####..............................................................................................................#####
#####..............................................................................................................#####
#####..............................................................................................................#####
#####..............................................................................................................#####
#####................................#...........................................#.................................#####
#####..............................##.............................................##...............................#####
#####...........................###....#.......................................#....###............................#####
#####.......................####........#######################################........####........................#####
#####..................#####...............................................................#####...................#####
###################................................................................................#####################
#####..............................................................................................................#####
#####..............................................................................................................#####
#####..............########################.................................#######################................#####
#####........................................############################..........................................#####
#####..............................................................................................................#####
#####..............................................................................................................#####
#####..............##########################............................#########################.................#####
#####.p..C.....#################################......................###############################.........c..P.#####
########################################################################################################################
########################################################################################################################