########################################################################################################################
########################################################################################################################
#####..............................................................................................................#####
#####..............................................................................................................#####
#####....................##############............................................................................#####
#####......................##########.......#####...############.........##########................................#####
#####.......#########.................................########.........##############..............................#####
#####.....#############.............#########...............................................#############..........#####
#####.............................#############...............................................#########............#####
#####.......................................................############...........................................#####
#####..................######.................................########..........#########..........................#####
#####................##########............#########..........................#############........................#####
#####....................................#############.............................................................#####
#####........................................................##########............................................#####
#####...############...........................................######.....................############.............#####
#####.....########............##########.........########...............................################...........#####
#####...........................######.........############............#####.......................................#####
#####................######..........................................#########.....................................#####
#####..............##########......................................................................................#####
#####..............................................##########.............................#########................#####
#####.p..C..........................................########............................#############.......c...P..#####
########################################################################################################################
########################################################################################################################