########################################################################################################################
########################################################################################################################
#####..............................................................................................................#####
#####..............................................................................................................#####
#####..............................................................................................................#####
#####..............................................................................................................#####
#####..............................................................................................................#####
#####..............................................................................................................#####
#####..............................................................................................................#####
#####..............................................................................................................#####
#####..............................................................................................................#####
#####..............................................................................................................#####
#####..............................................................................................................#####
#####..............................................................................................................#####
#####..............................................................................................................#####
#####..............................................................................................................#####
#####..............................................................................................................#####
#####..............................................................................................................#####
#####..............................................................................................................#####
#####..............................................................................................................#####
#####..............................................................................................................#####
#####p.C.......................................................................................................c.P.#####
########################################################################################################################
########################################################################################################################