########################################################################################################################
########################################################################################################################
#####..............................................................................................................#####
#####..............................................................................................................#####
#####.........................................................................................................C..p.#####
#####.P..c................................................................................##############################
#####################..............................................................................................#####
#####..................................................####################........................................#####
#####....................########################...............................##########.........................#####
#####..............................................................................................................#####
#####..............................................................................................................#####
#####.....................................................................................##########...............#####
#####..............................................................................................................#####
#####..............................................................................................................#####
#####................................................................................................###################
#####..............................................................................................................#####
#####..............................................................................................................#####
#####................................................................................############..................#####
#####..............................................................................................................#####
#####..............................................................................................................#####
##########..............#####...........#####.............#####..............######..............######............#####
########################################################################################################################
########################################################################################################################