########################################################################################################################
########################################################################################################################
#####.........#...................................#................................................................#####
#####.........#...................................#................................................................#####
#####.........#....................##########.....#######################...############################################
#####.........######################...............................................................................#####
#####.........#........................##########################################################..................#####
#####.........#........................#........................................................#..................#####
#####.........#.....####################........................................................#############......#####
#####.........#.................................................................................#..................#####
#####.........#.............................########...######################....################..................#####
#####.........#############.................#...............................#...................#......#################
#####.........#..................############...............................#...................#..................#####
#####.........#..................#................#####################.....#############.......#..................#####
#####.........####################................#..............#......................#.......#############......#####
#####.........#........................############..............#......................#.......#..................#####
#####.........#..................................................##############......####.......#..................#####
###############..................................................#..............................#......#################
#####.................######################################.....#..........#############.......#..................#####
#####........................#...................................#..........#...................#..................#####
#####.p..C...................#...................................#..........#...................#.............c..P.#####
########################################################################################################################
########################################################################################################################